{
  "cols": 19,
  "rows": 21,
  "mazes": [
    [
      "###################",
      "#........#........#",
      "#o##.###.#.###.##o#",
      "#.................#",
      "#.##.#.#####.#.##.#",
      "#....#...#...#....#",
      "####.###.#.###.####",
      "   #.#...:...#.#   ",
      "####.#.##-##.#.####",
      "T......#=G=#......T",
      "####.#.#####.#.####",
      "   #.#.......#.#   ",
      "####.#.#####.#.####",
      "#........#........#",
      "#.##.###.#.###.##.#",
      "#o.#....FPF....#.o#",
      "##.#.#.#####.#.#.##",
      "#....#...#...#....#",
      "#.######.#.######.#",
      "#.................#",
      "###################"
    ],
    [
      "###################",
      "#........#........#",
      "#.##.###.#.###.##.#",
      "#.................#",
      "#o##.#.#####.#.##o#",
      "#....#...#...#....#",
      "####.###.#.###.####",
      "   #.#...:...#.#   ",
      "####.#.##-##.#.####",
      "T......#=G=#......T",
      "####.#.#####.#.####",
      "   #.#.......#.#   ",
      "####.#.#####.#.####",
      "#........#........#",
      "#.##.###.#.##.###.#",
      "#o.#....FPF..#..o.#",
      "##.#.#.#####.#.#.##",
      "#....#...#...#....#",
      "#.######.#.######.#",
      "#.................#",
      "###################"
    ]
  ]
}
